R 1010 700
NO textures/wall_4.xpm
SO textures/wall_1.xpm
WE textures/wall_2.xpm
EA textures/wall_3.xpm
S textures/pillar.xpm
F 123,0,0
C 192,255,0
11111111111111
11000111100001
10000000000001
10000000000001
10000000000001
1100000W000021
10000000000011
10002000000001
10002000000001
10000000000001
10000000000001
11111111111111