R 1010 700
NO textures/wall_1.xpm
SO textures/wall_2.xpm
WE textures/wall_3.xpm
EA textures/wall_4.xpm
S textures/sprite_1.xpm
F 123,0,224
C 119,179,225
             1111111111111111111111
             1000000000000111100001
             1000000000000100000001
             1000000000000100000001
11111111111111000000000000000000001
10000000000000000000000000001111111
10000000000000000000000000001      
10000000000000000000000000001      
10000000000000000N00000000001      
10000000000000000000000000001      
10000111110000000000000000001      
100001   10000000000000000001111   
100001   10000000000000000001       
111111   11111111111111111111      
