          R 1010 700
         NO textures/wall_1.xpm
SO               textures/wall_2.xpm
    WE      textures/wall_3.xpm
EA textures/wall_4.xpm
S  textures/pillar.xpm
         F 123,        0,0
C 192,255,0
111111111111
100000110001
100000010001
1000000000011111111111
1000000000000000000001
1000000000000000000001111111111111111
1000000000000000000000000E00000000001
1111111000001111111111100000002222001
1000000000001         100000000000011
1000000000001         100000000000001
1000000000001         100000000000001
1111111111111         111111111111111