R 1010 700
SO textures/wall_2.xpm
WE textures/wall_3.xpm
EA textures/wall_4.xpm
NO textures/wall_1.xpm
S textures/sprite_1.xpm
C 200,100,123
F 0,234,190
             1111111111111111111111
             1000000020000111100001
             1000000000000100000001
             1000000000000100222001
11111111111111000000200000000000001
10000200000000000000000000001111111
10000000000000000000000000201      
10020000000020000000000000001      
10000000000000000N00000000001      
10222200000020000000000000001      
10000111110000000000000002001      
100001   10000000000220000001111   
100201   10000000000000000001       
111111   11111111111111111111      
