R 1010 700
NO textures/wall_1.xpm
SO textures/wall_2.xpm

WE textures/wall_3.xpm
EA textures/wall_4.xpm
S textures/sprite_1.xpm
F 123,0,0
C 192,239,125
11111111111111
11000111100001
10000000000001
12000000000001
12000000000001
1100000N000021
10000000000011
10000000000001
10000000000001
10002000000001
12222222222221
11111111111111