          R 1010 700
SO               textures/wall_1.xpm
         NO textures/eagle.png
    WE      textures/wood.png
EA textures/wall_2.xpm
S  textures/pillar.xpm
         F 12,        130,50
C 192,255,0


11111111111
10002220011
1000000N01
11111111111
10002220001
10002200001
11111111111



